25 27
11 26
19 19 19 19 19 19 19 19 19 11 11 11 11 19 19 19 19 19 19 19 19 19 19 19 19
11 11 11 11 11 11 11 11 11 11 13 13 11 19 19 19 19 19 19 19 19 19 19 19 19
11 10 10 10 11 10 10 10 11 11 13 13 11 19 19 19 19 19 19 19 19 19 19 19 19
11 10 10 10 11 10 10 10 11 11 13 13 11 11 11 11 11 11 11 11 11 11 19 19 19
18 10 10 10 10 10 10 10 11 11 13 13 10 10 10 10 10 10 10 10 10 11 19 19 19
18 10 10 10 10 10 10 10 11 11 13 13 10 10 10 10 10 10 10 10 10 11 19 19 19
11 10 10 10 11 11 11 11 11 11 13 13 11 11 11 11 11 11 11 10 10 11 19 19 19
18 10 10 10 10 10 10 10 11 11 13 13 11 10 10 11 10 10 11 10 10 11 11 19 19
18 10 10 10 10 10 10 10 11 11 13 13 11 10 10 11 10 11 11 10 10 11 11 11 19
11 10 10 10 11 10 10 10 11 11 13 13 11 10 10 11 11 12 12 12 12 12 12 12 11
11 10 10 10 11 10 10 10 11 11 13 13 11 10 10 11 12 12 12 12 12 12 12 12 11
11 10 10 10 11 11 11 11 11 11 13 13 11 10 10 11 12 12 12 12 12 12 12 12 11
11 10 10 10 10 10 10 10 10 10 13 13 11 10 10 11 12 12 12 12 12 12 12 12 11
11 10 10 10 10 10 10 10 10 10 13 13 11 10 10 11 12 12 12 12 12 12 12 12 11
11 11 11 11 11 11 11 11 11 11 13 13 11 10 10 11 12 12 12 12 12 12 12 12 11
19 19 19 19 19 19 19 19 19 11 13 13 11 10 10 11 12 12 12 12 12 12 12 12 11
19 19 19 19 19 19 19 19 19 11 13 13 11 10 10 11 12 12 12 12 12 12 12 12 11
11 11 11 11 11 11 19 19 19 11 13 13 11 10 10 11 12 12 12 12 12 12 12 12 11
11 10 10 10 10 11 19 19 19 11 13 13 11 10 10 10 11 12 12 12 12 12 12 11 19
11 10 10 10 10 11 19 19 19 11 13 13 11 10 10 10 10 11 11 10 10 11 11 19 19
11 10 10 10 10 11 11 11 11 11 13 13 11 10 10 10 10 10 11 10 10 11 19 19 19
11 10 10 10 10 10 10 10 10 10 13 13 11 11 11 11 11 11 11 10 10 11 19 19 19
11 10 10 10 10 10 10 10 10 10 13 13 10 10 10 10 10 10 10 10 10 11 19 19 19
11 10 10 10 10 11 11 11 11 11 13 13 10 10 10 10 10 10 10 10 10 11 19 19 19
11 10 10 10 10 11 19 19 19 11 13 13 11 11 11 11 11 11 11 11 11 11 19 19 19
11 10 10 10 10 11 19 19 19 11 13 13 11 19 19 19 19 19 19 19 19 19 19 19 19
11 10 10 10 10 11 19 19 19 11 13 13 11 19 19 19 19 19 19 19 19 19 19 19 19
11 11 11 11 11 11 19 19 19 11 11 11 11 19 19 19 19 19 19 19 19 19 19 19 19
