20 20
640 1142
19 15 15 15 15 15 15 15 15 15 15 15 15 15 15 15 15 15 15 18
12 11 11 11 11 11 11 11 11 11 11 11 11 11 11 11 11 11 11 13
12 11 11 11 11 11 11 11 11 11 11 11 11 11 11 11 11 11 11 13
12 11 11 11 11 11 11 11 11 11 11 11 11 11 11 11 11 11 11 13
12 11 11 11 11 11 11 11 11 11 11 11 11 11 11 11 11 11 11 13
12 11 11 11 11 11 11 11 11 11 11 11 11 11 11 11 11 11 11 13
12 11 11 11 11 11 11 11 11 11 11 11 11 11 11 11 11 11 11 13
12 11 11 11 11 11 11 11 11 11 11 11 11 11 11 11 11 11 11 13
12 11 11 11 11 11 11 11 11 11 11 11 11 11 11 11 11 11 11 13
12 11 11 11 11 11 11 11 11 11 11 11 11 11 11 11 11 11 11 13
12 11 11 11 11 11 11 11 11 11 11 11 11 11 11 11 11 11 11 13
12 11 11 11 11 11 11 11 11 11 11 11 11 11 11 11 11 11 11 13
12 11 11 11 11 11 11 11 11 11 11 11 11 11 11 11 11 11 11 13
12 11 11 11 11 11 11 11 11 11 11 11 11 11 11 11 11 11 11 13
12 11 11 11 11 11 11 11 11 11 11 11 11 11 11 11 11 11 11 13
12 11 11 11 11 11 11 11 11 11 11 11 11 11 11 11 11 11 11 13
12 11 11 11 11 11 11 11 11 11 11 11 11 11 11 11 11 11 11 13
12 11 11 11 11 11 11 11 11 11 11 11 11 11 11 11 11 11 11 13
12 11 11 11 11 11 11 11 11 11 11 11 11 11 11 11 11 11 11 13
17 14 14 14 14 14 14 14 14 14 14 14 14 14 14 14 14 14 14 16