11 24
250 2250
19 15 15 15 18 26 19 15 15 15 18 
12 11 11 11 13 26 12 11 11 11 13 
12 11 11 11 13 26 12 11 11 11 13 
12 11 11 11 13 26 12 11 11 11 13 
12 11 11 11 13 26 12 11 11 11 13 
12 11 11 11 13 26 12 11 11 11 13 
12 11 11 11 13 26 12 11 11 11 13 
12 11 11 11 13 26 12 11 11 11 13 
12 11 11 11 13 26 12 11 11 11 13 
12 11 11 11 13 26 12 11 11 11 13 
12 11 11 11 13 26 12 11 11 11 13 
12 11 11 11 13 26 12 11 11 11 13 
12 11 11 11 13 26 12 11 11 11 13 
12 11 11 11 13 26 12 11 11 11 13 
12 11 11 11 13 26 12 11 11 11 13 
12 11 11 11 13 26 12 11 11 11 13 
12 11 11 11 13 26 12 11 11 11 13 
12 11 11 11 13 26 12 11 11 11 13 
12 11 11 11 13 26 12 11 11 11 13 
12 11 11 11 13 26 12 11 11 11 13 
12 11 11 11 13 26 12 11 11 11 13 
12 11 11 11 13 26 12 11 11 11 13 
12 11 11 11 13 26 12 11 11 11 13 
17 14 14 14 16 26 17 14 14 14 16 
