11 8
228 143
19 15 15 15 15 15 15 15 15 15 18 
12 11 11 11 11 11 11 11 11 11 13 
12 11 11 11 11 11 11 11 11 11 13 
12 11 11 11 11 11 11 11 11 11 13 
12 11 11 11 11 11 11 11 11 11 13 
12 11 11 11 11 11 11 11 11 11 13 
12 11 11 11 11 11 11 11 11 11 13 
17 14 14 14 14 14 14 14 14 14 16 
