20 20
971 68
19 15 15 18 19 34 15 18 19 15 15 18 19 15 33 15 33 15 18 26 
12 11 11 13 12 11 11 13 12 11 11 13 12 11 11 11 11 11 24 18 
12 11 11 13 12 11 11 13 12 32 31 13 12 11 11 11 11 11 11 13 
12 11 11 24 25 11 11 13 12 27 28 13 12 11 11 11 11 11 11 13 
12 11 11 11 11 11 11 13 12 27 28 24 25 11 11 22 23 11 11 13 
12 11 11 11 11 11 11 13 12 27 28 11 11 11 11 13 12 11 11 13 
12 11 11 22 14 14 14 16 12 27 28 11 11 11 11 13 12 11 11 13 
12 11 11 24 15 34 15 15 25 27 28 22 23 11 11 13 12 11 11 13 
12 11 11 11 11 11 11 11 11 27 28 13 12 11 22 16 17 14 14 16 
12 11 11 11 11 11 11 11 11 27 28 13 12 11 24 15 15 33 15 18 
17 14 14 14 14 14 14 14 23 27 28 13 12 11 11 11 11 11 11 13 
19 15 34 15 15 15 18 26 12 27 28 13 12 11 11 11 11 11 11 13 
12 11 11 11 11 11 13 26 12 27 28 13 12 11 11 11 22 23 11 13 
12 11 11 11 22 14 16 26 12 27 28 13 17 14 14 14 16 12 11 13 
12 11 11 11 24 15 15 15 25 27 28 24 15 15 33 15 15 25 11 13 
12 11 11 11 11 11 11 11 11 27 28 11 11 11 11 11 11 11 11 13 
12 11 11 11 11 22 14 14 23 27 28 22 23 11 11 11 11 11 11 13 
12 11 11 11 11 13 26 26 12 30 29 13 12 11 11 11 11 11 11 13 
17 23 11 11 11 13 26 26 12 11 11 13 12 11 11 11 11 11 22 16 
26 17 14 14 14 16 26 26 17 14 14 16 17 14 14 14 14 14 16 26 
