11 10
550 600
19 15 15 15 15 15 15 15 15 15 18 
12 11 11 12 11 11 11 13 11 11 13 
12 15 15 19 11 11 11 18 15 15 13 
12 11 11 32 31 11 32 31 11 11 13 
12 11 11 27 28 11 27 28 11 11 13 
12 11 11 27 28 11 27 28 11 11 13 
12 11 11 27 28 11 27 28 11 11 13 
12 11 11 27 28 11 27 28 11 11 13 
12 11 11 30 29 11 30 29 11 11 13 
17 14 14 14 14 14 14 14 14 14 16 
