10 20
320 1142
1 1 1 1 1 1 1 1 1 1
3 0 0 0 2 2 0 0 0 4
1 1 1 0 2 2 0 0 0 4
3 0 1 1 2 2 1 1 0 4
3 0 1 0 2 2 0 1 0 4
3 0 0 0 2 2 0 1 0 4
3 0 0 0 2 2 0 1 0 4
3 0 0 0 2 2 0 1 1 1
3 0 0 0 2 2 0 0 0 4
3 0 0 0 2 2 0 0 0 4
3 0 0 0 2 2 0 0 0 4
3 0 0 0 2 2 0 0 0 4
3 0 0 0 2 2 0 0 0 4
3 0 0 0 2 2 0 0 0 4
3 0 0 0 2 2 0 0 0 4
3 0 0 0 2 2 0 0 0 4
3 0 0 0 2 2 0 0 0 4
3 0 0 0 2 2 0 0 0 4
3 0 0 0 2 2 0 0 0 4
1 1 1 1 1 1 1 1 1 1