20 20
640 1142
10 6 6 6 6 6 6 6 6 6 6 6 6 6 6 6 6 6 6 9
3  0 0 0 0 0 0 0 0 0 0 0 0 0 0 0 0 0 0 4
3  0 0 0 0 0 0 0 0 0 0 0 0 0 0 0 0 0 0 4
3  0 0 0 0 0 0 0 0 0 0 0 0 0 0 0 0 0 0 4
3  0 0 0 0 0 0 0 0 0 0 0 0 0 0 0 0 0 0 4
3  0 0 0 0 0 0 0 0 0 0 0 0 0 0 0 0 0 0 4
3  1 1 1 0 0 0 0 0 0 0 0 0 0 0 0 0 0 0 4
3  0 0 0 1 0 0 0 0 0 0 0 0 0 0 0 0 0 0 4
3  0 0 0 0 1 1 0 0 0 0 0 0 0 0 0 0 0 0 4
3  0 0 0 0 0 0 1 1 0 0 1 1 0 0 0 0 0 0 4
3  0 0 0 0 0 0 0 0 0 0 0 0 1 1 1 0 0 0 4
3  0 0 0 0 0 0 0 0 0 0 0 0 0 0 0 1 0 0 4
3  0 0 0 0 0 0 0 0 0 0 0 0 0 0 0 0 1 0 4
3  0 0 0 0 0 0 0 0 0 0 0 0 0 0 0 0 1 0 4
3  0 0 0 0 0 0 0 0 0 0 0 0 0 0 0 1 0 0 4
3  0 0 0 0 0 0 0 0 0 0 0 0 0 0 0 1 0 0 4
3  0 0 0 0 0 0 0 1 0 0 1 0 0 0 1 0 0 0 4
3  0 0 0 0 0 0 0 0 0 0 0 0 0 0 0 1 0 0 4
3  0 0 0 0 0 0 0 0 0 0 0 0 0 0 0 1 0 0 4
8  5 5 5 5 5 5 5 5 5 5 5 5 5 5 5 5 5 5 7
