11 10
550 600
26 26 26 19 15 15 15 18 26 26 26 
26 26 26 12 11 11 11 13 26 26 26 
19 15 15 25 11 11 11 24 15 15 18 
12 11 11 32 31 11 32 31 11 11 13 
12 11 11 27 28 11 27 28 11 11 13 
12 11 11 27 28 11 27 28 11 11 13 
12 11 11 27 28 11 27 28 11 11 13 
12 11 11 27 28 11 27 28 11 11 13 
12 11 11 30 29 11 30 29 11 11 13 
17 14 14 14 14 14 14 14 14 14 16 
