20 20
640 1142
26 19 15 15 15 15 15 18 19 15 15 18 19 15 15 15 15 15 18 26
19 25 11 0  0  0  0  13 12 11 11 13 12 0  0  0  0  0  24 18
12 0  0  0  0  0  0  13 12 32 31 13 12 0  0  0  0  0  0  13
17 14 14 14 14 23 0  13 12 27 28 13 12 0  0  0  0  0  0  13
19 15 15 15 15 25 0  13 12 27 28 13 12 0  0  22 23 0  0  13
12 0  0  0  0  0  0  13 12 27 28 13 12 0  0  13 12 0  0  13
12 0  0  22 14 14 14 16 12 27 28 13 12 0  0  13 12 0  11 13
12 0  0  24 15 15 15 15 25 27 28 13 12 0  0  13 12 0  11 13
12 0  0  0  0  0  0  0  0  27 28 13 12 0  22 16 17 14 14 13
12 0  0  0  0  0  0  0  0  27 28 13 12 0  24 15 15 15 15 13
17 14 14 14 14 14 14 14 23 27 28 13 12 0  0  0  0  0  0  13
19 15 15 15 15 15 18 26 12 27 28 13 12 0  0  0  0  0  0  13
12 0  0  0  0  0  13 26 12 27 28 13 12 0  0  0  22 23 0  13
12 0  0  22 14 14 16 26 12 27 28 13 17 14 14 14 16 12 0  13
12 0  0  24 15 15 15 15 25 27 28 24 15 15 15 15 15 25 0  13
12 0  0  0  0  0  0  0  0  27 28 0  0  0  0  0  0  0  0  13
12 0  0  0  0  22 14 14 23 27 28 22 23 0  0  0  0  0  0  13
12 0  0  0  0  13 26 26 12 30 29 13 12 0  0  0  0  0  0  13
17 23 0  0  0  13 26 26 12 11 11 13 12 0  0  0  0  0  22 16
26 17 14 14 14 16 26 26 17 14 14 16 17 14 14 14 14 14 16 26
