20 20
640 1142
26 19 15 15 15 15 15 15 15 15 15 15 15 15 15 15 15 15 18 26
19 25 11 11 11 11 11 11 11 11 11 11 11 11 11 11 11 11 24 18
12 11 11 11 11 11 11 11 11 11 11 11 11 11 11 11 11 11 11 13
12 11 11 11 11 11 11 11 11 11 11 11 11 11 11 11 11 11 11 13
12 11 11 11 11 11 11 11 11 11 11 11 11 11 11 11 11 11 11 13
12 11 11 11 11 11 11 11 11 11 11 11 11 11 11 11 11 11 11 13
12 11 11 11 11 11 11 11 11 11 11 11 11 11 11 11 11 11 11 13
12 11 11 11 11 11 11 11 11 11 11 11 11 11 11 11 11 11 11 13
12 11 11 11 11 11 11 11 11 11 11 11 11 11 11 11 11 11 11 13
12 11 11 11 11 11 11 11 11 11 11 11 11 11 11 11 11 11 11 13
12 11 11 11 11 11 11 11 11 11 11 11 11 11 11 11 11 11 11 13
12 11 11 11 11 11 11 11 11 11 11 11 11 11 11 11 11 11 11 13
12 11 11 11 11 11 11 11 11 11 11 11 11 11 11 11 11 11 11 13
12 11 11 11 11 11 11 11 11 11 11 11 11 11 11 11 11 11 11 13
12 11 11 11 11 11 11 11 11 11 11 11 11 11 11 11 11 11 11 13
12 11 11 11 11 11 11 11 11 11 11 11 11 11 11 11 11 11 11 13
12 11 11 11 11 11 11 11 11 11 11 11 11 11 11 11 11 11 11 13
12 11 11 11 11 11 11 11 11 11 11 11 11 11 11 11 11 11 11 13
17 23 11 11 11 11 11 11 11 11 11 11 11 11 11 11 11 11 22 16
26 17 14 14 14 14 14 14 14 14 14 14 14 14 14 14 14 14 16 26
